111111
122221
120021
120021
122221
111111